11111111111111111101
10501000000000071031
10001000111118101001
10000001106011111001
10000000000000000001
11100111000010010001
10000000000000000001
11111111001111111111
10000210011000000001
11011100111000100111
10000000111111100121
10000000000000000121
10001000000011111101
11111111000000010001
16001000000000010111
10002000010000000001
11111111110011111601
10500000210010001011
10000000000000000001
11111111111111111141