11111111111111111111
10000100000000100001
10000100000030100001
10000100100100100001
11111111100111111111
10000100100100100001
10000111100111100001
10000000000000000001
10000000000000000001
10000000002000000001
10000000020000000001
11110000000000000001
18010000000000000001
10010000000000000001
10010000000000000001
10011111110000011111
10000000000000011111
11111111110000011111
10000000000000011111
14111111111111111111