11111111111111111101
10000000100000220031
18101010101111111101
11101010101000000001
10050010101200000001
10111011171111111001
10101000101000101001
10100001101100000001
10110111000111110111
10000000010000000001
11110111000111110101
11000011101100000101
10011000101111011101
10510012101000201101
10111110101010101101
10000100001011150001
11010101101001001101
10110111101101111101
12000000001000000001
14111111111111111111