10111111111111111111
13000000000000015001
10000000000000011101
10000011111110010101
10000000060010011101
10000000000000010001
10000000000000011101
11110000000000000001
10010000000000000001
10010000070000010001
10011111000111111111
10010200000112810601
11110000000110000001
10000110000110000001
10000010000000000001
16000110000200000001
11111110100111111111
12101010100100000001
10000000100000000001
11111111111111111141